遥远的救世主（天道原著王志文主演电视剧畅销遥远的救世主作者豆...	作者: 豆豆
蛤蟆先生去看心理医生（年销200万册！英国经典心理咨询入门书，知...	作者: 罗伯特・戴博德
次第花开 修订版	作者: 希阿荣博堪布
活着（余华代表作，精装，易烊千玺推荐阅读。当当专享印签藏书票...	作者: 余华
女孩别怕 所有女性都用得上的安全经验（教你如何鉴别渣男，告诉你...	作者: 田静・女孩别怕团队
你当像鸟飞往你的山（中文版销量超200万册，比尔・盖茨年度特别推...	作者: 塔拉
中华人民共和国民法典（64开便携版 压纹烫金版）2020年6月新版	作者: 法律出版社
三体：全三册 刘慈欣代表作，亚洲“雨果奖”获奖作品！	作者: 刘慈欣
小熊和最好的爸爸（全7册）	作者: 阿兰德・丹姆
马尔克斯：百年孤独（50周年纪念版）	作者: 加西亚・马尔克斯
月光落在左手上（精装珍藏版）	作者: 余秀华
被讨厌的勇气：“自我启发之父”阿德勒的哲学课 岸见一郎	作者: 岸一郎
时间从来不语，却回答了所有问题（文学大师季羡林百岁人生的智慧...	作者: 季羡林
少年读史记（套装全5册）	作者: 张嘉骅
我想要两颗西柚（大张伟私藏书单，力荐阅读。你们是平等的，那个...	作者: 胡辛束
人生海海（麦家重磅力作，莫言、董卿盛赞，连续两年高居畅销榜，...	作者: 麦家
乌合之众 : 大众心理研究（群体心理学创始人古斯塔夫・勒庞代表作...	作者: 古斯塔夫・勒庞
置身事内：中国政府与经济发展（罗永浩、罗振宇、何帆、刘格菘、...	作者: 兰小欢
消失的13级台阶（罗翔推荐！荣获日本推理小说至高荣誉江户川乱步...	作者: 高野和明
沉思录	作者: 马可.奥勒留